name ColinPip
size 11 11

WWWWWWWWWWW
WOOOOOOOOOW
WOOOOOOWOOW
WOOWWOOWOOW
WOOOOOOWOOW
WOOOOOOWOOW
WOOOOOOWOOW
WOOWWOOWOOW
WOOOOOOWOOW
WOOOOOOOOOW
WWWWWWWWWWW



         E

     P   E

         E



A historical curiosity.
