name SuperSimple
size 16 16

WWWWWWWWWWWWWWWW
WEOOOOOOOOOOOOOW
WOOOOOHOOOOOOOOW
WOOOOOHOOOOOOOOW
WOOOOOHOOOOHHHHW
WOOOOOHOOOOOOOOW
WOHHHHHOOOOOOOOW
WOOOOOOOOOOOOOOW
WOOOOOOOOOOOOOOW
WOOOOOOOOWWWWWOW
WOOOOOOOOWOOOOOW
WOOOHOOOOWOOOWWW
WOOOHOOOOWOOOOOW
WOOOHOOOOWOWOOOW
WOOOHOOOOOOWOOOW
WWWWWWWWWWWWWWWW

  EE         EE
 EE           E
 E









 E
 EE           P

First map made using the builtin editor!
