18 15
WWWWWWWWWWWWWWWWWW
WWWWWWWW  WWWWWWWW
WWWWWWWW  WWWWWWWW
W                W
W                W
WWWWWWWW  WWWWWWWW
WWWWWWWW  WWWWWWWW
WWWWWWW    WWWWWWW
WWWWWW      WWWWWW
WWWWW   WW   WWWWW
WWWW   WWWW   WWWW
WWW   WWWWWW   WWW
WW   WWWWWWWW   WW
W   WWWWWWWWWW   W
WWWWWWWWWWWWWWWWWW
                  
        P         
                  
                  
                  
                  
                  
                  
                  
     E      E     
    E        E    
   E          E   
  E            E  
 E              E 
                  
This map is a big deal.
