level 1
name E-Way
next map02
size 25 40

WWWWWWWWWWWWWWWWWWWWWWWWW
WOOOOOOOOWOOOOOOOOWOOOOOW
WOOOOOOOOWOOOOOOOOWOOOOOW
WOOOOOOOOHOOOOOOOOWWHHOOW
WOOOWWOOOOOOOWWOOOOOOOOOW
WOOOWWOOOOOOOWWOOOOOOOOOW
WOOOOOOOOHOOOOOOOOOOOEOOW
WOOOOOOOOWOOOOOOOOOOOOOOW
WOOOOOOOOWOOOOOOOOOOOOOOW
WWWHOOHWWWWWWWWWWWWWWWWWW
WOOOOOOOOW
WOOOOOOOOW
WOOWWWWOOW
WOOOOOOOOW
WOOOOOOOOW
WWWHOOHWWWWWWWWWWWWWWWWWW
WOOOOOOOOWOOOOOWOOOOOOOOW
WOOOOOOOOWOOOOOWOOOOOOOOW
WOOOOOOOOHOOWOOWOOWOOOOOW
WOOOWWOOOOOOWOOOOOWOOOOOW
WOOOWWOOOOOOWOOOOOWOOOOOW
WOOOOOOOOHOOWOOWOOWOOOOOW
WOOOOOOOOWOOOOOWOOOOOOOOW
WOOOOOOOOWOOOOOWOOOOOOOOW
WWWHOOHWWWWWWWWWWWWWWWWWW
WOOOOOOOOW
WOOOOOOOOW
WOOWWWWOOW
WOOOOOOOOW
WOOOOOOOOW
WWWHOOHWWWWWWWWWWWWWWWWWW
WOOOOOOOOWOOOOOOOOOOOOOOW
WOOOOOOOOWOOOOOOOOOOOOOOW
WOOOOOOOOHOOOOOOOOOOOEOOW
WOOOWWOOOOOOOWWOOOOOOOOOW
WOOOWWOOOOOOOWWOOOOOOOOOW
WOOOOOOOOHOOOOOOOOWWHHOOW
WOOOOOOOOWOOOOOOOOWOOOOOW
WOOOOOOOOWOOOOOOOOWOOOOOW
WWWWWWWWWWWWWWWWWWWWWWWWW

                   E
                   EE
   E  E     E  E


   E  E     E  E











   E  E              P


   E  E              P











   E  E     E  E


   E  E     E  E
                   EE
                   E

Entry point.
