level 5
name WhatIsThis
next map07
size 30 39

WWWWWWWWWWW
WOOOOOOOOOW
WOOOOOOOOOW
WOOHHHHHOOW        WWWWWWWWWWW
WOOHOWOHOOW        WOOOOOOOOOW
WOOHHHHHOOW        WOOOOOOOOOW
WOOOOOOOOOW        WOOHHHHHOOW
WOOOOOOOOOW        WOOHOWOHOOW
WWWWWWWWOOWWWWWWWWWWOOHHHHHOOW
       WOOOOOOOOOOOOOOOOOOOOOW
       WOOOOOOOOOOOOOOOOOOOOOW
       WOOWWWWWWWWWWWWWWWWWWWW
       WOOWOOOOOOOOOOOOOOOW
       WOOWOOOOOOOOOOOOOOOW
    WWWWOOOOOHOOHOHOHOOHOOW
    WOOWOOOOHOHOHOHOHOHOHOW
    WOOWOOWOHOHOHOHOHOHOHOW
    WOOWOOWOOHOOOHOHOOOHOOW
    WOOWOOWOOOOOOOOOOOOOOOW
    WOOWOOWOOOOOOOOOOOOOOOW
    WOOWOOWWWWWWWWWWWWWWWWW
    WOOOOOW
    WOOOOOW
WWWWWWWWOOW  WWWWWWWWWWWWWWWWW
WOOOOOOOOOW  WOOOOOOOOOOOOOOOW
WOOOOOOOOOW  WOEOHOOOOOOOOHOOW
WOOWWWWWWWW  WOOOHOOOOOOOOHHOW
WOOHOOW      WOHHHOOOOOOOOOOOW
WOOHOOW      WOOOOOOOOOOOOOOOW
WOOHOOW      WOOOOOOOOOOHHHHOW
WOOHOOW      WOOOOOOOOOOHOOOOW
WOOHOOW      WOOOOOOOOOOOOOOOW
WOOWWWWWWWWWWWWWWWWWWWWWWOOWWW
WOOOOOOOOOOOOOOOOOOOOOOOOOOW
WOOOOOOOOOOOOOOOOOOOOOOOOOOW
WWWWWWWWWWWWWWWWWWWWWWWWWOOW
           WOOOOOOOOOOOOOOOW
           WOOOOOOOOOOOOOOOW
           WWWWWWWWWWWWWWWWW

 P


    E E             E       E


                       E E







     EE      E   E E   E
     EE      E   E E   E







                E
               EE
              EEE
    E
    E
    E
    E
    E




            EE
            EE

I notice your playing...
