level 3
name Arena
next map05
size 32 32

WWWWWWWWWWWWWWWWWWWWWWWWWWWWWWWW
WOOOOOOOOOOOOOOOOOOOOOOOOOOOOOOW
WOOOWOOOOOOOOOOOOOOOOOOOOOOWOOOW
WOOOWOOOOOOOOOOOOOOOOOOOOOOWOOOW
WOWWWOOOOOOOOOOOOOOOOOOOOOOWWWOW
WOOOOOOOOOOOOOOOOOOOOOOOOOOOOOOW
WOOOOOOOOOOOOOOOOOOOOOOOOOOOOOOW
WOOOOOOOWOOOOOOOOOOOOOOWOOOOOOOW
WOOOOOOWWWOOOOOOOOOOOOWWWOOOOOOW
WOOOOOOOWOOOOOOOOOOOOOOWOOOOOOOW
WOOOOOOOOOOOOOOOOOOOOOOOOOOOOOOW
WOOOOOOOOOOOOOOOOOOOOOOOOOOOOOOW
WOOOOOOOOOOOOOOOOOOOOOOOOOOOOOOW
WOOOOOOOOOOOOOOOOOOOOOOOOOOOOOOW
WOOOOOOOOOOOOOOOOOOOOOOOOOOOOOOW
WOOOOOOOOOOOOOOEEOOOOOOOOOOOOOOW
WOOOOOOOOOOOOOOEEOOOOOOOOOOOOOOW
WOOOOOOOOOOOOOOOOOOOOOOOOOOOOOOW
WOOOOOOOOOOOOOOOOOOOOOOOOOOOOOOW
WOOOOOOOOOOOOOOOOOOOOOOOOOOOOOOW
WOOOOOOOOOOOOOOOOOOOOOOOOOOOOOOW
WOOOOOOOOOOOOOOOOOOOOOOOOOOOOOOW
WOOOOOOOWOOOOOOOOOOOOOOWOOOOOOOW
WOOOOOOWWWOOOOOOOOOOOOWWWOOOOOOW
WOOOOOOOWOOOOOOOOOOOOOOWOOOOOOOW
WOOOOOOOOOOOOOOOOOOOOOOOOOOOOOOW
WOOOOOOOOOOOOOOOOOOOOOOOOOOOOOOW
WOWWWOOOOOOOOOOOOOOOOOOOOOOWWWOW
WOOOWOOOOOOOOOOOOOOOOOOOOOOWOOOW
WOOOWOOOOOOOOOOOOOOOOOOOOOOWOOOW
WOOOOOOOOOOOOOOOOOOOOOOOOOOOOOOW
WWWWWWWWWWWWWWWWWWWWWWWWWWWWWWWW


                            E
   P                        EE



       E E            E E

       E E            E E













       E E            E E

       E E            E E



  EE                        EE
   E                        E


Open arena deathpit of fun!
