level 1
name Daimap
next map03
size 18 15

WWWWWWWWWWWWWWWWWW
WWWWWWWWOOWWWWWWWW
WWWWWWWWOOWWWWWWWW
WOOOOOOOOOOOOEOOOW
WOOOOOOOOOOOOOOOOW
WWWWWWWWOOWWWWWWWW
WWWWWWWWOOWWWWWWWW
WWWWWWWOOOOWWWWWWW
WWWWWWOOOOOOWWWWWW
WWWWWOOOWWOOOWWWWW
WWWWOOOWWWWOOOWWWW
WWWOOOWWWWWWOOOWWW
WWOOOWWWWWWWWOOOWW
WOOOWWWWWWWWWWOOOW
WWWWWWWWWWWWWWWWWW

        P







     E      E
    E        E
   E          E
  E            E
 E              E

This map is a big deal.
