name CRIMEBOX
size 35 23

WWWWWWWWWWWWWWWW
WOOWOOOOOOOOOOOW
WOWWOOOOOOOOOOOW
WOOOOOOOOOOOOOOW
WOOOOOHHHHOOOOOW
WOOOOOHOOHOOOOOWWWWWWWWWWWWWWWWWWWW
WOOOOOHHHHOOOOOOOOOOOOOOOOOOOOOOOOW
WOOOOOOOOOOOOOOWWWWWWWWWWWWWWWWWWOW
WOOOOOOOOOOOOOOW                WOW
WWWWWWWWWWWOOOWW                WOW
WWWWWWWWWWWOOOWW                WOW
WOOOOOOOOOOOOOOWWWW             WOW
WOOOOOOOOOOOOOOOOOW    WWWWWWWW WOW
WOOOOOOOWWWWWWWWOOW    WOOOOOOW WOW
WOOOOOOOWWWWWWWWOOWWWWWWHHHHHHWWWOW
WOOOOOOOHOOOOOOHOOOOOOOOOOOOOOOOOOW
WOOOOOOOHOEOOOOOOOOOOOOOOOOOOOOOOOW
WOOOOOOOHOOOOOOOOOOOOOOOOOOOOOOOOOW
WOOOOOOOWWWWWWWWOOWWWWWWHHHHHHWWWWW
WOOOOOOOWWWWWWWWOOW    WOOOOOOW
WOOOOOOOOOOOOOOOOOW    WWWWWWWW
WOOOOOOOOOOOOOOOOOW
WWWWWWWWWWWWWWWWWWW

 P



       EE
                  E     E     E




  E

                         EEEE

  E       E            E    E
  E       E            E    E
          E            E    E

                         EEEE

  E

Seryder's Criminal Cube
