level 2
name Daimap
next map03
size 49 49

WWWWWWWWWWWWWWWWWWWWWWWWWWWWWWWWWWWWWWWWWWWWWWWWW
WHHHHHHHHHHHHHHHHHHHHHHHHHHHHHHHHHHHHHHHHHHHHHHHW
WHOOOOOOOOOOOOOOOOOOOOOOOOOOOOOOOOOOOOOOOOOOOOOHW
WHOOOOOOOOOOOOOOOOOOOOOOEOOOOOOOOOOOOOOOOOOOOOOHW
WHOOOOOOOOOOOOOOOOOOOOOOOOOOOOOOOOOOOOOOOOOOOOOHW
WHOOOOOOOOOOOOOOOOOOOOHHHHHOOOOOOOOOOOOOOOOOOOOHW
WHOOOOOOOOOOOOOOOOOOOOHWWWHOOOOOOOOOOOOOOOOOOOOHW
WHOOOOOOOOOOOOOOOOOOOOHWWWHOOOOOOOOOOOOOOOOOOOOHW
WHOOOOOOOOOOOOOOOOOOOOHWWWHOOOOOOOOOOOOOOOOOOOOHW
WHOOOHHHHHHHHHHHHHHHHHHWWWHHHHHHHHHHHHHHHHHHOOOHW
WHOOOHWWWWWWWWWWWWWWWWWWWWWWWWWWWWWWWWWWWWWHOOOHW
WHOOOHWWWWWWWWWWWWWWWWWWWWWWWWWWWWWWWWWWWWWHOOOHW
WHOOOHHHHHHHHHHHHHHHHHHWWWHHHHHHHHHHHHHHHHHHOOOHW
WHOOOOOOOOOOOOOOOOOOOHHWWWHHOOOOOOOOOOOOOOOOOOOHW
WHOOOOOOOOOOOOOOOOOOOHWWOWWHOOOOOOOOOOOOOOOOOOOHW
WHOOOOOOOOOOOOOOOOOOOHWWOWWHOOOOOOOOOOOOOOOOOOOHW
WHHHHHHHHHHHHHOOOOOOOHWWOWWHOOOOHHHHHHHHHHHHHOHHW
WWWWWWWWWWWWWHOOOOOOHHWWOWWHHOOOHHWWWWWWWWWHOOOHW
WWWWWWWWWWWWHHOOOOOOHWWOOOWWHOOOOHWWWWWWWWWHOOOHW
WWWWWWWWWWWWHOOOOOOOHWWOOOWWHOOOOHWWWWWWWWWHOHOHW
WWWWWWWWWWWWHOOOOOOOHWWOOOWWHOOOOHHWWWWWWWWHOOOHW
WWWWWWWWWWWWHOOOOOOHHWWOOOWWHHOOOOHWWWWWWWWHOOOHW
WWWWWWWWWWWHHOOOOOOHWWWOOOWWWHOOOOHWWWWWWWWHHOHHW
WWWWWWWWWWWHOOOOOOOHWWOOOOOWWHOOOOHHWWWWWWWHOOOHW
WWWWWWWWWWWHOOOOOOHHWWOOOOOWWHHOOOOHWWWWWWWHOOOHW
WWWWWWWWWWHHOOOOOOHWWWOOOOOWWWHOOOOHWWWWWWWHOHOHW
WWWWWWWWWWHOOOOOOOHWWOOOOOOOWWHOOOOHHWWWWWWHOHOHW
WWWWWWWWWWHOOOOOOHHWWOOOOOOOWWHHOOOOHWWWWWWHOOOHW
WWWWWWWWWHHOOOOOOHWWWOOOOOOOWWWHOOOOHHWWWWWHOOOHW
WWWWWWWWWHOOOOOOOHWWOOOOOOOOOWWHOOOOOHWWWWWHHOHHW
WWWWWWWWWHOOOOOOHHWWOOOOOOOOOWWHHOOOOHHWWWWHOOOHW
WWWWWWWWHHOOOOOOHWWWOOWWWWWOOWWWHOOOOOHWWWWHOOOHW
WWWWWWWWHOOOOOOHHWWOOOHOOOHOOOWWHHOOOOHHWWWHOHOHW
WWWWWWWHHOOOOOOHWWWOOOOOOOOOOOWWWHOOOOOHHWWHOOOHW
WWWWWWWHOOOOOOHHWWOOOOOOOOOOOOOWWHHOOOOOHHWHOOOHW
WWWWWWHHOOOOOOHWWWOOOOOOOOOOOOOWWWHOOOOOOHHHHOHHW
WWWWWWHOOOOOOHHWWOOOOOHOOOHOOOOOWWHHOOOOOOOOOOOHW
WHHHHHHOOOOOHHWWWWWWWWWOOOWWWWWWWWWHHOOOOOOOOOOHW
WHOOOOOOOOOHHWWWOOOOOOWOOOWOOOOOOWWWHHOOOOOOOOOHW
WHOOOOOOOHHHWWWOOOOOOOWOOOWOOOOOOOWWWHHHOOOOOOOHW
WHOOOOOHHHWWWWOOOOOOOOHOOOHOOOOOOOOWWWWHHHOOOOOHW
WHOOOHHHWWWWWOOOOOOOOOHOOOHOOOOOOOOOWWWWWHHHOOOHW
WHOOOHWWWWWOOOOOOOOOOOOOOOOOOOOOOOOOOOWWWWWHOOOHW
WHOOOHHHHHHOOOOOOOOOOOOOOOOOOOOOOOOOOOHHHHHHOOOHW
WHOOOOOOOOOOOOOOOOOOOOOOOOOOOOOOOOOOOOOOOOOOOOOHW
WHOOOOOOOOOOOOOOOOOOOOOOOOOOOOOOOOOOOOOOOOOOOOOHW
WHOOOOOOOOOOOOOOOOOOOOOOOOOOOOOOOOOOOOOOOOOOOOOHW
WHHHHHHHHHHHHHHHHHHHHHHHHHHHHHHHHHHHHHHHHHHHHHHHW
WWWWWWWWWWWWWWWWWWWWWWWWWWWWWWWWWWWWWWWWWWWWWWWWW



                E   E       E   E



        E   E   E   E       E   E   E   E





                    E
                             EE
                             EE
                    E                        E


                              EE
                   E    P

                               EE            E
                  E

                                EE
                 E


                E                            E

               E

              E        E E

             E         E E                   E
            E
           E
          E
        E        E E E     E E E
      E
                 E E         E E

                 E             E





This map is a big deal.
