name E-Way
next map02
size 16 12

WWWWWWWWWWWWWWWW
WOOOOOOOOOOOOOOW
WOOOOOOOOOOOOOOW
WOOOOOOOWWWWWWWW
WOOOOOOOWWWWWWWW
WOOOOOOOOOOOOOOW
WOOOOOOOOOOOOOOW
WOOOOOOOWWWWWWWW
WOOOOOOOWWWWWWWW
WOOOOOOOOOOOOOOW
WOOOOOOOOOOOOOEW
WWWWWWWWWWWWWWWW


              P


        E     E
        E     E


        E     E
        E     E

Entry point.
